11111111111111111111111111111111
1C000000000000000000000000000001
10000000000000000000000P010000C1
10000000000000000000000001111101
10000000000000000000000001000E01
100000C0000000000000000001111101
11111111111111111111111111111111
